**XX*****X*X**X***X*X*********X**X*X*XXX*X**X*XX*X*X**X**X********X**XXX**X*X***************XX*X*X*X
X***X*XX****X***XX**XXXXXXXX*XXX*X****X***X**********X*X*X*X*X*XXX**X*X*X*****XXX*X*X*X*X*X*********
X*X****X*XX***X****X**********X***X*XX**X***X*XX*X*XX*****X***X**X*X******X*XX***X***X*X**X*X*X*XX*X
***X*X*XX*X*XX*X*X*XX*X*X*X*XX**XX***X*XX*X*XX*XXXX**X*X*X**X**X*X**X*X*X*XX*X*X**X*X***X**X***XXX*X
X*XXX******XX***X***X**X*X***X*X***X*X*X**X**X***X*X*X*XX**X**X****X***X******XXX**XX*X*X*X*X*XXX***
***X**X*XX****XX*X*X*XX****XX***X*XXX**XX*XX***XX****X**X*X*XX**X*X*X*XXX*XX*X*X*X*****X****X*XX*X*X
X*X*X**XX*X*X*X**X***X**X*X***XX***X**X*****XXXX*XXX**X*X*****X*X*X****X*X***X****XX*X**X*XX******X*
X****XX****X*X*X***XXXX*X**X*X***X*X*X*X*X*X*********XX**XXXX*XX****XX***X*X*XXX*X***X*XXX**X*X*X***
**X*X*XX*XXX*X***XX**X*X**XX**X*XXX**X**X**XX*X*X*XX*X*X*********X*X*X*X*X*X***X*X*X*XX*X*X**X*XXX*X
*X*******X*****X*X*X*****XX**XX**X**X**X*X**X*X**X***X***X*X*X*X**X*****X**X*X*X*X*X******X*XX**X*XX
**XX*X*X**X*X*X*X***X*X*X***XX**X**X*X*****X**XX**X*X**X*XX**X**X**X*X*X*X**X****X**X*X*X******X**XX
*XX***X**X***X****X**X***X*X***XXX*X***XX*X**X*X*X*XXX**X**X*X*X*X**X*****X*X*X*X*X*X*X*XX*X*X*X*X*X
***X*X*X**X*X*X*XX*XX**X****X*XXX**XXX*XX*X*X*******X**XXX*XXX****XX*XXXXX***X**X****X****X***X*****
*X*X****X**X**X******X*XX*XX***X**X******X**XX*X*XX**X**X*****X*XX*X******XX**X*X*X*X*X*X**X*X*X*X*X
*XXXX*X*X*XXX***XX*X**X*X*X**X*X*X*X*X*XX**X*X**X**XX**X**XX*X*XXX*X*X*X*X**X**X**X*X****X*X***X*X**
***X*X**X**X*X*X*X*X*X******XXX**X*XX**X**X****XXX**X*XXXXX*****X***X*X***X**X*X*X***X*XX***X*X**X*X
XX****X*XXX*******X*X**X*XX**X**X****X**X**XXX*XX*X****X***X*XX**X*X***X*X**X*****X*X*X**XXX***X**X*
***XXX****XXXX*XX*X***X**XX*XX*XX*X*X**X**X********X*X*X*XX*XX*X***X*XXX*XX***X*X*X***X*X***X*X**X**
XX*X***XX*******X**X*X**X******X**X*X*X**X*X*X*XX*XXX*X*********X*X********X*X***X*X*X***X*X**X*XX*X
***XX*X**X*XXX*X*X**X**X*X*XX*X*X*X*X*X*X***X****X*X***X*XX*XXX****XXX*X*X****X*X****XX*X***XX**X***
X*X****X**X***X**X*X**X***X******X**XX**XX*X*X*X***X*X**X**X****X*X**X**X**XX**X**X*X*X*XX*XX**X*X*X
***X*X*X*X*X*X*X***XX*XXX**XX*X*X**X***X********X*X***XX**X*XX*XX**X*X*X*XXX**X**XX*X*X****X*X*X****
*X*X**X*********X*X*XX***X*X***X**X*X*X*XXXXXX*X**X*XX**X*X****X*X**********X*X*XX****X*X*X**X***X*X
*X*X*X**XXX*X*X********X*X**X*X*X*****X*********X*X*X*X*X*X*X*X***X*X*X*X*X**X****X*XX*XX**X*X*X**X*
X**X*X*X**XX*X**XX*XXX*X**X*X*X***X*XX*XX*X*X*X*XX**********X**X*X*X***X*X*XX**X*X***X***X*X****X***
*X*XX*X**X****X*XXX****XX*X*****XX*X*****XXX**X***XX*X*X*XXX*X*X*X*X*X******X*XX**XX**X*XX**X*XX*XXX
******X*XXX*X**X*X**XXX***XX*X*X***X*X*X**X*X*X*X***X***X**X**X****X**X*X*XXX*X*XX***X**X**X***X****
*XX*X****XX**X*X**XX**XX*X****X**X*X*X*X*X****X**X*X**X*X*X**X*XX*X**X*X*X*******X*X**X**X*X*XX**XX*
X*XX*X*X****X***X**X*X***X*X*X**X**X**X*XXX*X*X*XX**X**X***X*******X*X****XX*X*XX***XX**X**X***X**X*
******XXXXX*XX*X**X**X*XX*XX**X**X*X*XX**X*X*XX***X*X*X*X*X**XX*X*X*X**XX***X***X*X***X**X**X*X**X**
X*XX*X*X******XX*X**XX*X*****XX*XX*X*X*X***X***XX**X**X*****X**X**X***XX*X*XX*XX***X*XX*X**X***X**X*
*X*X*X**XX*XX*X****X****XX*X*X**X********XX*X*X**XX**X*X*X*X*X*X*X**X*X****X***X*XXX*X**X*X*X*X**X*X
*******X**X****XXX**XXXX*XX****X**XX*X*X****X*X*XX**XX****X**X**X**X***X*X**X*X*****X*X*X*X*X**X****
*XX*X*XXX*X*XX*X**X********XXX**X*X***X*XX*X*******X***X*X*X**X*X*X**X*XX**X***XX*XX**********XX*X*X
***X*X*X*****XX*X*XX*X*XXX*****XX**X*X*******XX*X*X*X*XX***X*X**X**XXXX***XX*XX***X**X*X*XXX*X**XX**
*X*X*X*X*X*X**X*****XXX****X*X*X**X*X**X*X*XX**X**X*****X*XX**X*X*X**X*X*X**X***X*X*XXX*XX*****X***X
X*********X*X***X*XX*X*XXX*XX**XX****X*X**X***X*X*X*XX*X****X***X*X*XX*X*X*X**X*X*X**X**X**X*X*X*X**
**XXX*X*X****XX**X***********X***XX*XXX**X*XX*X****XXXX**X*X*X*X**X*X******X*X***XX*X**X**X**X**X**X
X****X*XXXX*X*X*XXX*XXXXXX*X**X*X**XXX*X*X*XX*X*XX**XXX*X**X*X**X*X*X*X*X*X**X*XX***X*X*XX**X*X*X*X*
*XX*X***X******X*X*X*****XX*XX*XX*X*X**X*X*******XX**X***XX***X***X*X**X***X**X***X*X*X*X*XX********
**X**X*X**XX*X*******XXX**********X***XXX*XX*X*X***X*X*X****X*XX*XX*X*X*X*X*X*X*XX*X****X****X*XX*XX
*X**X****XXXX*XX*X*X*X**X*XX*X*XX***X*XX****X*X*X*X*****XXX*X**X*X**X****X*******X**X*X*X*XX*XX***X*
*X*X**X*XXXXX*XXX*X**X*X****X****XX*X****XX*X******X*X*X*****XX**X*X**X*X*X*XX*X***XXX**X***X**XX***
**XX*X*X*XXX***X****XX*X*X*X*X*X*X**XXXX*X***XX*XX*X**XXX*XX***X****X*X*X*X*X*X*XX**X*X**X*XX*X**X*X
X******X**X*X*X*X*XX****X*****X***XX*****XXX*X*XX***X*XX****X*X*X*X**X*X********XX*X****X**X***X*X**
X*X*XX*X*XX*******XXX*X*XX*XX**X*X*XX*XXX**X*X***X*XXX***X*X*X**X*XX*X*X*XX*X*X***XXX*X**XX**X*****X
***X**XX***X*XX*XX*X***X*XX**X*X*X**XX***X****X*X***X*X*X******X****X****XX*X*X*XXXX***XX***X*X*X*X*
X*X*X****XX*XX**X****X*****X*X*X*X*X**XX*X*XX****XXX****XX*XXXX**XX*X*X*X****X****X**X*X**X*X**X****
*X***X*X**X*X*X**X*X*X*X*XX*****XX***XX*****X*XX****XX*X*XX****X*X*****X*XXX**XX*X**XX*X*XX**X***X*X
**X*X*X**X******X***XXXXX***X*X*X**XX***XXX**X**XXX*X*X*****XX**X**XX*X******X****X***X****X**X*X***
*X**X**X**X*X*X**X*X*X*X*X*X*XX**X****XX**XX**X*******X*XXX*X*X*X*X*X**X*X*X*X*X*X*X*X*X*X*X*X*XXX*X
**X*X*X**X*X*X**X******X*X*X*X**X**XX*X*X**X*X*X*XXX*X**X***X***XX**X*X*X**XX*X*X******XX***X***X***
*X**X**X******X**X*X*XX*******XX**XX*X****X**X**X******X*X*X**XX***X**X***X*******XX*X**X*XX**X**X*X
**X*X*X**X*X*X**X***X*X*XX*X*X**XX****X*X**XX*X***X*XX*X****X**X*X**X**X*XX*X*XXX*X***X*X*X**X**X***
*X****XX**X*X**XX*X***X*X*X*X*X***X*X***X*X****XX**X****X*X**X**X**X**X**X*XX*X**X*XX**X**X*X**X*X*X
**X*X**X*X**XX*X***X*X**X*******XX***X*X*X*X*X****X**XX*X*X*XXX**X***X*X*X*X**X*X*****X*X*X*X*X**X**
*X***X*X**X*****X*X***XXXX*XXX*XX*X*X*X**X***XX*X**X***X*X***X*X**X*X*******X*X*X*X*XX*******X*X*X*X
**X*X*X**X**XXX*X*X*X***X*X****X****X***X*X*X***XX*X*X*X**X*XX**X*X**XXXXX*X**X**X***X*X*XX*X**X****
*X****X*X*XX**X*X*X**X*X***X*X**X*X*X*XXX**XXXXX*X**XX*XX******X*X*XX*****X*X*X*X*X*X***X*X*X*XX*X*X
**X*X*X*X*X*X***X*XX*XX**X*X**X**X**X*****X*X******X****X*XX*X********XXX*X***X***XX*X*X**X*X*X*X***
*XX**X********XXXX******X*X*XX**X**XX*XX*XX**X*X*XX**XX**XXXX**X*XXXX*X**X*XX*X*XX****XXX********X*X
****X*X*XX*X*X**X**XXX*X******X*X*X***XXX***X*X**X**X*XX*XXX**XXX*****X*X***X*X*X*XX*X*X*X*XX*X*X***
XX*XX**X*XX***X**X*X*X**XXX*X*X*X**X*X*XX*X****X**X*X*****X**X*X**XXXX***X*X******X**X*******XX**X*X
******X*****X*X*X*X***X****X**X***XX*X*****XX*XX*X*X**X*X**XX***X*X****XX**X*XXXX**X***X*X*XX***XX**
*XXX*X*X*X*X**X*X*XX*X*X*XX**XX*X******X*X*X**X**X***XXXX*X**XX****XX*X*X*X******X**X*X*X*X*X*X***XX
***X*X*X**X*XX*****X***X*X**XX***X*X*X**X***XX*XX**XXXX***X*X***XXXX******X*X*X*XXX*X*X***X*X*XXXXX*
*XX******X**X*X*X*X*XX*****XX**X**X*XX*X**X******XX**X*X*X****XX*****X*X*X***X**XXX**X**XX**********
**X*XX*XX*X******X***XXXX*XX**X*XX****X**X**XX*X****X**X*X*X*X**X*X*XXXXX**X*XX**X**XXX*XX*XXXX*XXX*
*X****X*****X*X*X*X*X***X*X**XX***XX*X*X**X***XXX*X*XX*X*X*XX**XXX***X*X**XXX***XXX*XX********X*X***
XXXX*X**XX*X*X*X******X***X*X***X*X******X**X**X***X******X**X**XXXX*X*X*X*X**XX*XX****XX*XX*XX*X*X*
*X**X*X*XXX******X*XX*X*XX***X*X***XX*X*X*X**X**X*X**X*XX***XX*X*X**********XX*X***X*XX*X*XX*X**X**X
***X**X**X**X*XX*X*X***X**X*XX*X*X*XXXXXX*X*X**XX**X**X**XX*X****X*XX*X*XXX******XXXX*******X**X*X**
*XX*X*XX**X*XX****X**X**X*X*X***X***X*X******X***XXX*X*X*****XX*X****X*X**X*XX*X***X**XX*XXX*X*X**X*
*X******X*X**X*XXXXX*X*X****XX*XXXXX**X*X*XX*X*XX*******XX*X*X***X*XX**X*X***XXX*X**XXX*X******X*X*X
**X*X*X*X*X*XXX***X*X***X*X**X**X**X*X*X**X**X*X**XXX*X*X*X***XX*****X*****XX***X*XX******XXXX*X*X**
*X***X******XX*XX****X*X**XX**X**X*X***X*X*X**XX*XX*X**X**XX*X**X*XX*X*XXX*X**XXX****XXXX*X******X*X
*X*XX**XX*XX*****X*XX***X**X*X**XX**X*X*X***XX***X****XXX*****X****X*X****X**XX***XX*X****X*XX*X***X
*****X*X*X**X*X*X***X*X***X*X**X***XX***X*XX***X**XX*X*X**X*X*X*X*X**X*XXX**XX**X*X**X*XXX****X*XX**
X*X*XXX****X***X*X*XX*XXX*****X*X*X***XX*****X*X*X**X****XX*X*X**X*X*X***X*X***X***XX*X***X*XX*****X
X*X**X*X*X*X*X***X*X****X*XXX*X***XX*XXXXXXXXXX****X*XX*X**X**X*X****X*X*X**X*X**XXX***XX*****XX*X**
***X****X*****XXX***XXX*XX*****X*X*X**XX*****X**XX***X**X*X**X***X*X*X*X*X*X***X*X***XX**XX*X*X**X*X
X*X**X*X*X*X*X***X*XX*****X*XX*******X***XX*X**X**X*X*X*X**XX*X*XXX**X**X**XX*X*XXX*X***X****XXX*X**
X*XX**X**X*XXX*X*X*X**X*X**X***X*XXX*X*XX*****XXX**X******XXX*X**X*X*X*XX*X***X**X***X*XX*XX**X*X*X*
****X***X*******X**X*X*XX*X*X*X**X**XXXX*X*XXX*X**X*X*X*X**X****XX***X*X***X*XXX**X*X**X****X******X
*X*X*X*X**XX*X*XXX**X**X*****X*XX**XXX***X*X*****XX*X*XXXX**X*X*X**X*X**X*X***X**X***X*X*X*X*X*X*X**
*X*X**XXX**X**X*X*X***X*X*X*X***X*X*X*XX*X*X*X*XX*******X*X*X*X*X*X**X*XX**X*XXX*X*XX**X*XX***X***XX
*X***X*X**X*X******X*X***X**X*X*X*X*X*X*****X****X*X*X*X**X**X***XXX*X*X**X***X**X*X**X*X***X*XX*X**
*X*X****X***XX*XX*X****X*XX*X*XX****X*X*XXX*X*X*XX*X*XX*X*X*X*X*XXX**X*X*X*X*X**X****X****X*X**XX**X
*X*X*X*X**XX*XX****X*XX***X*X**X*X*X*******X*X******X*X*****X****X*X*X*X*X****X**X*X*X*XX*X*X*X**X**
*X**X**X*X******X*X*X**XX*X*XX**X****XX*X*X***X*X*X*X***X*XX**X*X****X*X*X*X*X**X**X**X***X**X*X*X*X
*X*X*X**X**X*XX**X****X********X*XXXX**XX**X*X*X*X**X*X*XX*XXX**X*X*X**X*X**X*X**X**X**X*X*XX*******
*X***X*X*X*X**X*X**X*XX*X*X*X*X**X***X***X***X****XX*X********X*X*X*X*X****X****X**XXX***X***X*XX*XX
X**XX*X****X*XX*XX**X****X*XX*XX*XX*X*X*X*XX*X*XX**X***XX*X*X*X**X***XXX*XXX*X*X*X**X*XX*XX*X*X***X*
*X*****XX*X**X****X*X*X*X*************X*X******X*X**X*X**X**X*X*X*X*XXX*******X***X*X*******X***X*X*
*X*XXX***X*X**X*X*X*X*XX**X*XX*X*X*XX*X*X*X*XX***XX**X*X**XX**X*X****X*XX*XX*X**X*X*X*XXXXX*XX*X****
***X*XX*X****X*X********X*XX****X***X*X*X*X***XX**XX****X****XX*X*X*XX*X***XX**X*X***XX********X*X*X
*X****X**X*X*X***X*XXXXX*X**X*X*X*XX*******X*X*XX**X*X*X*X*XXX*X***X****X*X*XX*****XX**X*XXXXX*XXX**
*X*XX**X**X***X*X*********X**X*X*X*X*X*X*X**X****X**X*****X****XX*XX*XX********XXX*X**X*X*********X*
**X***X*XX*X*X***X*X*X*X*X**XX*X*X*X*XX*X*X**X*X**X**X*X*XX*XXX*XX***X*X*X*X*X***X**X***X*XXXXXXX*X*
*X**X****X****X*X***X***XXX****************X****X**X**X************X****X***X**X**X**XX*********X*X*
