###################
#               O #
#   P     #########
#                 #
#                 #
############      #
#  O      ##      #
#         ##      #
#                 #
#                 #
#                 #
#           XX    #
#                 #
#                 #
###################