11111111
10101001
10001101
11010111
10100101
10011001
11010101
10010001
11111111

