11111111111
10101000001
10001101101
11010110101
10100101011
10011000111
11010101011
10010000101
10000100101
11001110101
10001000101
11111111111
